Catharanthus_roseus	Eudicots
Allamanda_cathartica	Eudicots
Ipomoea_purpurea	Eudicots
Rosmarinus_officinalis	Eudicots
Tanacetum_parthenium	Eudicots
Inula_helenium	Eudicots
Diospyros_malabarica	Eudicots
Kochia_scoparia	Eudicots
Carica_papaya	Eudicots
Arabidopsis_thaliana	Eudicots
Hibiscus_cannabinus	Eudicots
Populus_trichocarpa	Eudicots
Boehmeria_nivea	Eudicots
Medicago_truncatula	Eudicots
Larrea_tridentata	Eudicots
Vitis_vinifera	Eudicots
Podophyllum_peltatum	Eudicots
Aquilegia_formosa	Eudicots
Eschscholzia_californica	Eudicots
Sarcandra_glabra	Chloranthales
Liriodendron_tulipifera	Magnoliids
Persea_americana	Magnoliids
Houttuynia_cordata	Magnoliids
Saruma_henryi	Magnoliids
Sabal_bermudana	Monocots
Yucca_filamentosa	Monocots
Smilax_bona_nox	Monocots
Colchicum_autumnale	Monocots
Dioscorea_villosa	Monocots
Acorus_americanus	Monocots
Zea_mays	Monocots
Sorghum_bicolor	Monocots
Brachypodium_distachyon	Monocots
Oryza_sativa	Monocots
Kadsura_heteroclita	Kadsura
Nuphar_advena	Nuphar
Amborella_trichopoda	Amborella
Cunninghamia_lanceolata	Outgroup
Juniperus_scopulorum	Outgroup
Taxus_baccata	Outgroup
Sciadopitys_verticillata	Outgroup
Prumnopitys_andina	Outgroup
Gnetum_montanum	Outgroup
Welwitschia_mirabilis	Outgroup
Ephedra_sinica	Outgroup
Cedrus_libani	Outgroup
Pinus_taeda	Outgroup
Cycas_rumphii	Outgroup
Cycas_micholitzii	Outgroup
Zamia_vazquezii	Outgroup
Ginkgo_biloba	Outgroup
Psilotum_nudum	Outgroup
Ophioglossum_petiolatum	Outgroup
Angiopteris_evecta	Outgroup
Pteridium_aquilinum	Outgroup
Alsophila_spinulosa	Outgroup
Equisetum_diffusum	Outgroup
Dendrolycopodium_obscurum	Outgroup
Pseudolycopodiella_caroliniana	Outgroup
Huperzia_squarrosa	Outgroup
Selaginella_moellendorffii_1kp	Outgroup
Selaginella_moellendorffii_genome	Outgroup
Leucodon_brachypus	Outgroup
Anomodon_attenuatus	Outgroup
Thuidium_delicatulum	Outgroup
Rhynchostegium_serrulatum	Outgroup
Bryum_argenteum	Outgroup
Rosulabryum_cf_capillare	Outgroup
Hedwigia_ciliata	Outgroup
Ceratodon_purpureus	Outgroup
Physcomitrella_patens	Outgroup
Polytrichum_commune	Outgroup
Sphagnum_lescurii	Outgroup
Marchantia_polymorpha	Outgroup
Marchantia_emarginata	Outgroup
Ricciocarpos_natans	Outgroup
Sphaerocarpos_texanus	Outgroup
Bazzania_trilobata	Outgroup
Metzgeria_crassipilis	Outgroup
Nothoceros_aenigmaticus	Outgroup
Nothoceros_vincentianus	Outgroup
Penium_margaritaceum	Outgroup
Cosmarium_ochthodes	Outgroup
Roya_obtusa	Outgroup
Netrium_digitus	Outgroup
Spirogyra_sp	Outgroup
Cylindrocystis_cushleckae	Outgroup
Mougeotia_sp	Outgroup
Cylindrocystis_brebissonii	Outgroup
Mesotaenium_endlicherianum	Outgroup
Coleochaete_irregularis	Outgroup
Coleochaete_scutata	Outgroup
Chaetosphaeridium_globosum	Outgroup
Chara_vulgaris	Outgroup
Entransia_fimbriata	Outgroup
Klebsormidium_subtile	Outgroup
Spirotaenia_minuta	Outgroup
Chlorokybus_atmophyticus	Outgroup
Mesostigma_viride	Outgroup
Uronema_sp	Outgroup
Monomastix_opisthostigma	Outgroup
Pyramimonas_parkeae	Outgroup
Nephroselmis_pyriformis	Outgroup
